##########################
#....###.###.#.#...#####E#
#.#....#.......#.#.#...#.#
#.#.#.##..####.#.#.#.#.#.#
#...#..####....#.#.#.....#
##......#...####.#.##.##.#
##..#####.###....#..#..#.#
##.##.......#.##.##...##.#
##.##.#####.#..#..###.#..#
##........#.#..##.###.##.#
##.######.######..###.#..#
#.....#...........###.##.#
#.....#.#.####.#......#..#
##.#..#.#.#..#.######.##.#
##.##...####........#..#.#
##..##....###.#.#####..#.#
##...####.#.#.#.#...#....#
#....#..#.#.....#.#...#..#
#.#..##.#.#######.######.#
#.##..#......#.......#.#.#
#........###.#...###.#.#.#
##..#.##.#...#####...#...#
#..##..#.##.....#..#.###.#
#.#...##..#.##.##..#####.#
#S##..#...#.#...#........#
##########################
