##########################
#...........#S#..........#
#...........#.#..........#
#...........#.#..........#
#...........#.#..........#
#...........#.#..........#
#...........#.#..........#
#...........#.#..........#
#...........#.#..........#
#.....#######.#..........#
#.....#.......#..........#
#.....#######.#..........#
#...........#.#####......#
#...........#.....#......#
#...........#.#####......#
#...........#.#..........#
#...........#.#..........#
#...........#.#..........#
#......######.#..........#
#......#......#..........#
#......#E######..........#
#......###...............#
#........................#
#........................#
#........................#
##########################
