##########################
#.#.#...#...#E...#.#.#.#.#
#.#.#...#.#.####.#.#.#.#.#
#.....#.#.###..#.#.#.#.#.#
#.###.#.#.#....#.#.#.#...#
#.###.#.#.#.####.#.#...#.#
#.###.#.#.#.##...#.##..#.#
#...#.###.#..#.###.....#.#
###.#.....#..#.#.....#.#.#
#.#.#####.#.##.#.###.#.#.#
#.#.#.......#..#...#.#.#.#
#.#.#.###..##.######.#.#.#
#.#.#.###.###..........###
#...#.###.######.###.....#
#...#.#........#.###.###.#
#####.#.####.#.#.....#...#
#.....#.##.#.#.####..#.###
#######.##.#.#.##.#.....##
#.......##.#.#..#.#.#...##
#.########.#.####...###.##
#.#.#......#......#.#.#.##
#.#...####.########...#.##
#.#.#...##.############.##
#.########.##########....#
#S....................#..#
##########################

