##########################
#......#S##E#......E.....#
#......#.##.#............#
#......#....#............#
#......######............#
#........................#
#........................#
#........................#
#........................#
#........................#
#........................#
#........................#
#........................#
#........................#
#........................#
#........................#
#........................#
#........................#
#........................#
#........................#
#........................#
#........................#
#........................#
#........................#
#........................#
##########################
