##########################
#........................#
#........................#
#........................#
#........................#
#........................#
#......##..#.............#
#...........#............#
#........................#
#............#...........#
#........................#
#........................#
#............#S..........#
#........................#
#..............#.........#
#............#...........#
#........................#
#........................#
#........................#
#........................#
#........................#
#........................#
#........................#
#........................#
#........................#
##########################
