##########################
#........................#
#........................#
#........................#
#........................#
#........................#
#........................#
#..........#..#..........#
#........................#
#......#....S.....#......#
#.......#........#.......#
#........#......#........#
#........##...###........#
#.........#####..........#
#....E...................#
#........................#
#........................#
#........................#
#........................#
#........................#
#........................#
#........................#
#........................#
#........................#
#........................#
##########################
