##########################
#........................#
#........................#
#........................#
#........................#
#........................#
#........................#
#.........#...#..........#
#........................#
#......#....S....#.......#
#.......#.......#........#
#.......##.....##........#
#........##...##.........#
#.........#####..........#
#........................#
#........................#
#........................#
#........................#
#........................#
#........................#
#........................#
#........................#
#........................#
#........................#
#........................#
##########################
