##########################
#........................#
#........................#
#........................#
#........................#
#........................#
#........................#
#..........#..#..........#
#........................#
#........................#
#............S...........#
#.......#................#
#.........#....#.........#
#...........#.#..........#
#........................#
#........................#
#........................#
#........................#
#........................#
#........................#
#........................#
#........................#
#........................#
#........................#
#........................#
##########################
